abażur	abażurek
ablegier	ablegierek
adidas	adidasek
adiutant	adiutancik
adrenalina	adrenalinka
adres	adresik
afera	aferka
akcent	akcencik
akt	akcik
akcydens	akcydensik
akordeon	akordeonik
aktorka	aktoreczka
akumulator	akumulatorek
akwarela	akwarelka
album	albumik
alegoria	alegoryjka
aleja	alejka
alkierz	alkierzyk
alkowa	alkówka
altana	altanka
aluzja	aluzyjka
amant	amancik
ambicja	ambicyjka
ancymon	ancymonek
anegdotka	anegdoteczka
anegdota	anegdotka
aniołek	aniołeczek
anioł	aniołek
ankieta	ankietka
anon	anonek
antałek	antałeczek
antał	antałek
antena	antenka
anyż	anyżek
aparat	aparacik
apartament	apartamencik
apetyt	apetycik
arak	araczek
arcydzieło	arcydziełko
argument	argumencik
arkada	arkadka
arkusz	arkusik
armata	armatka
armia	armijka
aromat	aromacik
aron	aronek
arsenał	arsenalik
artykuł	artykulik
as	asik
atlas	atlasik
atmosfera	atmosferka
audycja	audycyjka
aureola	aureolka
auto	autko
autobus	autobusik
autoportret	autoportrecik
awans	awansik
awantura	awanturka
ażur	ażurek
baba	babcia
babka	babcia
babka klozetowa	babcia klozetowa
babka	babeczka
bąbel	bąbelek
babina	babinka
baba	babka
babulka	babuleńka
babula	babulka
babcia	babunia
babunia	babusia
bachmat	bachmacik
bachor	bachorek
bat	bacik
bak	baczek
bąk	bączek
baki	baczki
badyl	badylek
bagatela	bagatelka
bagaż	bagażyk
bagno	bagienko
bagnet	bagnecik
bajt	bajcik
bajka	bajeczka
bajer	bajerek
bajoro	bajorko
bałagan	bałaganik
bałaguła	bałagułka
balas	balasek
balet	balecik
baletnica	baletniczka
balia	balijka
bal	balik
balkon	balkonik
ballada	balladka
balustrada	balustradka
bałwan	bałwanek
bambosz	bamboszek
bank	banczek
bandaż	bandażyk
bandera	banderka
banderola	banderolka
bandolet	bandolecik
bandura	bandurka
baniak	baniaczek
bańka	banieczka
bania	bańka
bankiet	bankiecik
barak	baraczek
baranek	baraneczek
baran	baranek
baranina	baraninka
barchan	barchanik
bariera	barierka
baron	baroniątko
barszcz	barszczyk
baryłka	baryłeczka
baryła	baryłka
basen	basenik
baskina	baskinka
bastion	bastionik
batalion	batalionik
bateria	bateryjka
baton	batonik
bawidło	bawidełko
bażant	bażancik
bazar	bazarek
bazia	baźka
bęben	bębenek
bet	becik
beka	beczka
beczka	beczułka
befsztyk	befsztyczek
bekiesza	bekieszka
belka	beleczka
bełkot	bełkocik
belweder	belwederek
beret	berecik
berżera	berżerka
bestia	bestyjka
biba	bibka
bibuła	bibułka
bicz	biczyk
bidula	bidulka
bidula	bidusia
biedak	biedaczek
biedronka	biedroneczka
biedula	biedulka
biesiada	biesiadka
bigos	bigosik
bilans	bilansik
bilet	bilecik
biszkopt	biszkopcik
bitwa	bitewka
biurko	biureczko
biust	biuścik
biznes	biznesik
bizon	bizonek
bizonię	bizoniątko
blat	blacik
blacha	blaszka
blizna	blizenka
bliźniak	bliźniaczek
blok	bloczek
blog	blogasek
blondas	blondasek
blondynek	blondyneczek
blondynka	blondyneczka
blondyn	blondynek
blondynka	blondzia
błona	błonka
błoto	błotko
bluzka	bluzeczka
bobas	bobasek
bochenek	bocheneczek
bocian	bocianek
bocianię	bocianiątko
bok	boczek
bogini	boginka
boja	bojka
bombka	bombeczka
bomboniera	bombonierka
bonus	bonusik
bór	borek
bóstwo	bóstewko
botwina	botwinka
bożę	bożątko
bóg	bożek
Bóg	Bozia
brat	braciszek
brama	bramka
bransoleta	bransoletka
brat	bratek
brawo	brawko
brelok	breloczek
brew	brewka
brodawka	brodaweczka
broda	bródka
broszka	broszeczka
broszura	broszurka
browar	browarek
brudas	brudasek
brud	brudek
brunet	brunecik
bruzda	bruzdka
bryka	bryczka
bryczka	bryczuszka
brydż	brydżyk
bryja	bryjka
brylant	brylancik
bryła	bryłka
brytfanna	brytfanka
brzękadło	brzękadełko
brzemię	brzemionko
brzeżek	brzeżeczek
brzeg	brzeżek
brzezina	brzezinka
brzoza	brzezinka
brzoskwinia	brzoskwinka
brzoza	brzózka
brzuch	brzuś
brzuch	brzusio
brzuch	brzuszek
brzuch piwny	brzuszek piwny
brzydula	brzydulka
brzytwa	brzytewka
bucik	buciczek
but	bucik
buk	buczek
buczyna	buczynka
buduar	buduarek
budynek	budyneczek
bufet	bufecik
bufa	bufka
buhaj	buhajek
bukiet	bukiecik
bukłak	bukłaczek
buława	buławka
bułka	bułeczka
bulwar	bulwarek
bulwka	bulweczka
bulwa	bulwka
burak	buraczek
bus	busik
busola	busolka
butelka	buteleczka
buziak	buziaczek
buzia	buźka
byk	byczek
bydło	bydełko
bydlę	bydlątko
Bydgoszcz	Bydzia
bylina	bylinka
cacko	cacuszko
całus	całusek
cap	capek
cęgi	cążki
ceber	ceberek
ceber	cebrzyk
cebula	cebulka
ceduła	cedułka
cegła	cegiełka
cekin	cekinek
cela	celka
cent	cencik
cera	cerka
cerkiew	cerkiewka
chabeta	chabetka
chałat	chałacik
chałtura	chałturka
chałupina	chałupinka
chałupa	chałupka
chałupnica	chałupniczka
chamówa	chamówka
charakter	charakterek
charcica	charciczka
chatka	chateńka
chata	chatka
cherlak	cherlaczek
cherubin	cherubinek
chęć	chętka
chichot	chichotek
chlebak	chlebaczek
chleb	chlebek
chleb	chlebuś
chlew	chlewek
chlew	chlewik
chłód	chłodek
chłopaczek	chłopaczątko
chłopak	chłopaczek
chłopczyk	chłopczątko
chłopiec	chłopczyk
chłop	chłopek
chłopię	chłopiątko
chłop	chłopię
chłopiec	chłopyś
chłopyś	chłopyszek
chmurka	chmureczka
chmura	chmurka
chochla	chochelka
chochoł	chochołek
chodak	chodaczek
chodnik	chodniczek
choinka	choineczka
cholewa	cholewka
chomąto	chomątko
chomik	chomiczek
chorągiew	chorągiewka
chór	chórek
choroba	choróbka
chrapa	chrapka
chrom	chromik
chrust	chruścik
chrypa	chrypka
chrzan	chrzanik
chrząszcz	chrząszczyk
chrześniak	chrześniaczek
chuchro	chucherko
chudziak	chudziaczek
chudzina	chudzinka
chuj	chujek
chustka	chusteczka
chusta	chustka
chwast	chwaścik
chwila	chwileczka
chwila	chwilka
chwila	chwilunia
chytrus	chytrusek
ciągoty	ciągotki
ciało	ciałko
ciastko	ciasteczko
cięciwa	cięciwka
cielak	cielaczek
cielę	cielątko
cielęcina	cielęcinka
cielica	cieliczka
ciemię	ciemiączko
ciepło	ciepełko
ciernik	cierniczek
ciotka	ciocia
ciotka	cioteczka
ciotka	ciotuchna
ciotka	ciotunia
cipa	cipcia
cipka	cipcia
cipa	cipeczka
cipka	cipeczka
cipa	cipka
cipcia	cipuszka
cipka	cipuszka
ciur	ciurek
ciuch	ciuszek
cmentarz	cmentarzyk
cokół	cokolik
córka	córcia
córka	córeczka
córeczka	córeńka
córeczka	córunia
córka	córuś
cudak	cudaczek
cudo	cudeńko
cukierek	cukiereczek
cukiernia	cukierenka
cukiernica	cukierniczka
cwaniak	cwaniaczek
ćwiartka	ćwiarteczka
ćwiartka	ćwiartuchna
ćwiek	ćwieczek
cybuch	cybuszek
cycek	cycuś
cycek	cycuszek
cyfra	cyferka
cyganka	cyganeczka
Cyganka	Cyganeczka
cygan	cyganek
Cygan	Cyganek
cygaro	cygarko
cylinder	cylinderek
cymbał	cymbałek
cymbały	cymbałki
cypel	cypelek
cyprys	cyprysik
cyranka	cyraneczka
cytat	cytacik
cytryna	cytrynka
czajnik	czajniczek
czamara	czamarka
czambuł	czambulik
czapka	czapeczka
czart	czarcik
czarcikęs	czarcikęsik
czarka	czareczka
czarnula	czarnulka
czarnucha	czarnuszka
czarnula	czarnuszka
cząstka	cząsteczka
część	cząstka
czaszka	czaszeczka
cząber	częborek
czekan	czekanik
czeladnik	czeladniczek
czepek	czepeczek
czerpak	czerpaczek
członek	członeczek
człowiek	człowieczek
czółko	czółeczko
czółno	czółenko
czoło	czółko
czop	czopik
czub	czubek
czupiradło	czupiradełko
czupryna	czuprynka
czwartak	czwartaczek
czynność	czynnostka
czyścioch	czyścioszek
dąb	dąbek
damula	damulka
dama	damusia
darmocha	darmoszka
dąs	dąsik
dąb	dębczak
dębina	dębinka
dębniak	dębniaczek
dekiel	dekielek
deklinacja	deklinacyjka
dekolt	dekolcik
delegacja	delegacyjka
delfin	delfinek
delia	delijka
demon	demonek
denar	denarek
dno	denko
deska	deseczka
deseń	desenik
deser	deserek
deszczułka	deszczułeczka
deska	deszczułka
deszcz	deszczyk
diabeł	diabełek
diablę	diablątko
diabeł	diablik
diament	diamencik
dieta	dietka
dioda	diodka
dirt	dircik
diuk	diuczek
dłutko	dłuteczko
dłuto	dłutko
dobry wujek	dobry wujaszek
dochód	dochodzik
dogodność	dogodnostka
doktor	doktorek
dokument	dokumencik
dołek	dołeczek
dół	dołek
dolina	dolinka
domek	domeczek
dom	domek
dom	domina
donos	donosik
dorsz	dorszyk
dowcipas	dowcipasek
dowcip	dowcipek
dowcip	dowcipuszek
drabina	drabinka
drabina	drabka
drablina	drablinka
dramat	dramacik
dranica	dranka
drąg	drążek
dres	dresik
dreszcz	dreszczyk
drewno	drewienko
drewniak	drewniaczek
drobiazg	drobiażdżek
drobina	drobinka
drobniak	drobniaczek
dromader	dromaderek
droga	dróżka
droga	drożyna
drożyna	drożynka
drut	drucik
druk	druczek
drukarnia	drukarenka
drużyna	drużynka
drwina	drwinka
drynda	dryndulka
drzewo	drzewko
drzwi	drzwiczki
dubeltówka	dubeltóweczka
dukat	dukacik
dupa	dupcia
dupa	dupeczka
dupka	dupeczka
duperela	duperelka
duperele	duperelki
dupa	dupka
duser	duserek
duch	duszek
dusza	duszyczka
dwójka	dwójeczka
dworek	dworeczek
dwór	dworek
dyby	dybki
dynamomaszyna	dynamomaszynka
dynastia	dynastyjka
dyrektor	dyrektorek
dyscyplina	dyscyplinka
dyszkant	dyszkancik
dytyramb	dytyrambik
dywan	dywanik
dzbanek	dzbaneczek
dzban	dzbanek
dzbanek	dzbanuszek
dżem	dżemik
dziad	dziadek
dziadek	dziadulek
dziadek	dziadunio
dziadek	dziaduś
dziadziuś	dziadzia
dziadziuś	dziadzio
dziadek	dziadziu
dziadek	dziadziuś
działka	działeczka
dziąsło	dziąsełko
dziatki	dziateczki
dzieciak	dzieciaczek
dzieciątko	dzieciąteczko
dziecię	dzieciątko
dziecko	dziecina
dziecina	dziecinka
dziedziniec	dziedzińczyk
dzieło	dziełko
dzielnica	dzielniczka
dzierżawa	dzierżawka
dziewczę	dziewczątko
dziewczynka	dziewczyneczka
dziewczynka	dziewczyniątko
dziewczyna	dziewczynka
dziewka	dzieweczka
dzieweczka	dzieweńka
dziewucha	dziewuszka
dzieża	dzieżka
dzióbek	dzióbeczek
dziób	dziobek
dziób	dzióbek
dziurka	dziureczka
dziura	dziurka
dziwa	dziwka
dziwoląg	dziwolążek
dziwotwór	dziwotworek
dźwignia	dźwigienka
dzwonek	dzwoneczek
dzwon	dzwonek
dzwonnica	dzwonniczka
efekt	efekcik
ekran	ekranik
ekwipaż	ekwipażyk
elaborat	elaboracik
elegant	elegancik
elementarz	elementarzyk
emblemat	emblemacik
emerytura	emeryturka
emotikona	emotikonka
epizod	epizodzik
Eskimos	Eskimosek
estrada	estradka
etat	etacik
etykieta	etykietka
fabryka	fabryczka
fabuła	fabułka
facet	facecik
facecja	facecyjka
fajka	fajeczka
fakt	fakcik
faktura	fakturka
falbanka	falbaneczka
fałdka	fałdeczka
fałd	fałdek
fałda	fałdka
fałd	fałdzik
fala	falka
falset	falsecik
familia	familijka
fantazja	fantazyjka
farba	farbka
fartuch	fartuszek
faseta	fasetka
fasola	fasolka
fasola szparagowa	fasolka szparagowa
fejs	fejsik
felieton	felietonik
festiwal	festiwalik
fetor	fetorek
fiat	fiacik
figiel	figielek
figura	figurka
filar	filarek
filet	filecik
filiżanka	filiżaneczka
film	filmik
filut	filutek
fiok	fioczek
fiołek	fiołeczek
firanka	firaneczka
firma	firemka
fiut	fiutek
flak	flaczek
flądra	fląderka
flakonik	flakoniczek
flakon	flakonik
flanela	flanelka
flaszka	flaszeczka
flet	flecik
flek	fleczek
flejtuch	flejtuszek
flirciara	flirciarka
flirt	flircik
flores	floresik
foka	foczka
foks	foksik
foksterier	foksterierek
folwark	folwarczek
fort	forcik
formuła	formułka
forteca	forteczka
fortepian	fortepianik
fotel	fotelik
fotografia	fotografijka
frak	fraczek
fragment	fragmencik
Francuz	francuzik
frazes	frazesik
frędzel	frędzelek
frędzla	frędzelka
fronton	frontonik
frota	frotka
frykas	frykasik
fryza	fryzka
fryzura	fryzurka
fujarka	fujareczka
funt	funcik
fundament	fundamencik
fundusz	fundusik
furka	fureczka
furmanka	furmaneczka
furtka	furteczka
futerał	futeralik
futro	futerko
gąbka	gąbeczka
gabinet	gabinecik
gablota	gablotka
gaduła	gadułka
gad	gadzik
gad	gadzina
gadzina	gadzinka
gaik	gaiczek
gaj	gaik
galareta	galaretka
gałązka	gałązeczka
gałąź	gałązka
gałka	gałeczka
galimatias	galimatiasik
galon	galonik
ganek	ganeczek
garb	garbik
garbus	garbusek
garbus	garbusik
gardło	gardełko
gardło	gardziołek
gardło	gardziołko
garnek	garnczek
garnitur	garniturek
garnuszek	garnuszeczek
garnek	garnuszek
garstka	garsteczka
garść	garstka
gąska	gąseczka
gąsię	gąsiątko
gąsienica	gąsieniczka
gąsior	gąsiorek
gęś	gąska
gąszcz	gąszczyk
gach	gaszek
gacie	gatki
gawęda	gawędka
gawronię	gawroniątko
gaździna	gaździnka
gazeta	gazetka
gbur	gburek
gęba	gębusia
gekon	gekonek
geniusz	geniuszek
gerbera	gerberek
gęśliki	gęśliczka
gęśle	gęśliki
gilotyna	gilotynka
gitara	gitarka
głąb	głąbek
głąb	głąbik
głaz	głazik
globus	globusik
głód	głodek
głodomór	głodomorek
glon	glonek
glorieta	glorietka
głos	głosik
główka	główeczka
główka	główeńka
głownia	głowienka
głowa	głowina
głowina	głowinka
głowa	główka
głupi	głupiątko
głupstwo	głupstewko
głuptak	głuptaczek
głuptas	głuptasek
głupek	głuptas
głuptas	głuptaś
gnat	gnacik
gniazdo	gniazdko
gnieciuch	gnieciuszek
gniew	gniewek
gniot	gniotek
gnój	gnojek
godzinka	godzineczka
gołąbek	gołąbeczek
gołąbka	gołąbeczka
gołąb	gołąbek
golas	golasek
gołąbek	gołębiątko
gołębica	gołębiczka
golf	golfik
golonka	goloneczka
gondola	gondolka
góralka	góraleczka
górka	góreczka
góra	górka
góry	górki
gorzałka	gorzałeczka
gotówka	gotóweczka
gówno	gówienko
grabina	grabinka
grabie	grabki
grat	gracik
gradowina	gradowinka
gradzina	gradzinka
grafika	graficzka
grajcar	grajcarek
grajdoł	grajdołek
granat	granacik
grat	gratek
gratis	gratisik
grób	grobek
grobelka	grobeleczka
grot	grocik
gród	gródek
gromada	gromadka
grosz	groń
grono	gronko
grosz	grosik
grubas	grubasek
gruby	grubcio
gruczoł	gruczołek
gruda	grudka
grunt	gruncik
grupa	grupka
gruszka	gruszeczka
grymas	grymasik
grypa	grypka
gryzak	gryzaczek
grzanka	grzaneczka
grzbiet	grzbiecik
grzebyk	grzebyczek
grzebień	grzebyk
grzeczność	grzecznostka
grzech	grzeszek
grzmot	grzmocik
grzyb	grzybek
grzywka	grzyweczka
gula	gulka
gumka	gumeczka
guma	gumka
gunia	guńka
gust	guścik
guz	guzek
guzik	guziczek
guziczek	guziczuszek
gwiazda	gwiazdeczka
gwiazdka	gwiazdeczka
gwiazda	gwiazdka
gwóźdź	gwoździk
gzyms	gzymsik
hak	haczek
hak	haczyk
haft	hafcik
hajdawery	hajdawerki
hajduk	hajduczek
halka	haleczka
halsztuk	halsztuczek
handel	handelek
harcap	harcapik
harcerz	harcerzyk
harem	haremik
harmonia	harmoszka
hasło	hasełko
hebel	hebelek
hełm	hełmik
herbata	herbatka
herb	herbik
hołota	hołotka
horror	horrorek
hotel	hotelik
huk	huczek
hufiec	hufczyk
humor	humorek
igiełka	igiełeczka
igła	igiełka
igielnik	igielniczek
ikona	ikonka
imadło	imadełko
imbryk	imbryczek
imię	imionko
impresja	impresyjka
impreza	imprezka
incydent	incydencik
indeks	indeksik
indor	indorek
inhalator	inhalatorek
inteligent	inteligencik
interes	interesik
intryga	intryżka
inżynier	inżynierek
irys	irysek
iskierka	iskiereczka
iskra	iskierka
istota	istotka
izba	izbeczka
izdebka	izdebeczka
jabłkówka	jabłkóweczka
jabłonka	jabłoneczka
jabłoń	jabłonka
jabłko	jabłuszko
jacht	jachcik
jagła	jagiełka
jagnię	jagniątko
jagoda	jagódka
jajko	jajeczko
jałówka	jałóweczka
jamka	jameczka
jama	jamka
jamnik	jamniczek
jar	jarczyk
jarzębina	jarzębinka
jarzyna	jarzynka
jasełka	jasełeczka
jasiek	jasieczek
jaskółka	jaskółeczka
jastrząb	jastrząbek
jaszczurka	jaszczureczka
jedlica	jedliczka
jedlina	jedlinka
jednoaktówka	jednoaktóweczka
jedzenie	jedzonko
jeleń	jelonek
jesionka	jesioneczka
jesion	jesionek
jeziorko	jezioreczko
jezioro	jeziorko
jęzor	jęzorek
język	języczek
jeż	jeżyk
jeżyna	jeżynka
jodła	jodełka
jogurt	jogurcik
jola	jolka
judasz	judaszek
junak	junaczek
junak	junaczka
jupka	jupeczka
kabat	kabacik
kabanos	kabanosek
kabaret	kabarecik
kabel	kabelek
kabinet	kabinecik
kabina	kabinka
kabłąk	kabłączek
kabriolet	kabriolecik
kacabaja	kacabajka
kąt	kącik
kaczę	kaczątko
kaczor	kaczorek
kaczuszka	kaczusia
kaczka	kaczuszka
kadet	kadecik
kadłub	kadłubek
kadzielnica	kadzielniczka
kaftanik	kaftaniczek
kaftan	kaftanik
kajak	kajaczek
kajuta	kajutka
kalafior	kalafiorek
kałamarz	kałamarzyk
kalarepa	kalarepka
kalendarz	kalendarzyk
kaleta	kaletka
kalina	kalinka
kalosz	kaloszek
kałuża	kałużka
kamasz	kamaszek
kamera	kamerka
kamienica	kamieniczka
kamyk	kamuszek
kamyk	kamyczek
kamień	kamyk
kanał	kanałek
kanał	kanalik
kanapka	kanapeczka
kanapa	kanapka
kanarek	kanareczek
kancelaria	kancelaryjka
kant	kancik
kangur	kangurek
kantor	kantorek
kapar	kaparek
kapeć	kapciuszek
kapka	kapeczka
kapelusz	kapelusik
kapelusz	kapelutek
kapka	kapeńka
kapilara	kapilarka
kapka	kapinka
kąpiel	kąpiołka
kapitał	kapitalik
kaplica	kapliczka
kapota	kapotka
kaprys	kaprysik
kaptur	kapturek
kapuśniak	kapuśniaczek
kapusta	kapustka
karafka	karafeczka
karawan	karawanik
karb	karbik
karty	karcięta
kark	karczek
karczma	karczemka
karczmarka	karczmareczka
kariera	karierka
karlica	karliczka
karmazyn	karmazynek
karmidło	karmidełko
karnet	karnecik
karniak	karniaczek
karp	karpik
kartka	karteczka
kartka	karteluszek
karta pocztowa	kartka pocztowa
kartofel	kartofelek
karton	kartonik
karykatura	karykaturka
karzeł	karzełek
kasar	kasarek
kąsek	kąseczek
kasiora	kasiorka
kasa	kaska
kaszel	kaszelek
kasza	kaszka
kaszkiet	kaszkiecik
kasztan	kasztanek
kątek	kąteczek
kąt	kątek
kawalątek	kawaląteczek
kawałek	kawalątek
kawałek	kawalątko
kawałek	kawałeczek
kawka	kaweczka
kawiarka	kawiareczka
kawiarnia	kawiarenka
kawior	kawiorek
kawa	kawka
kawa	kawunia
kawa	kawusia
kędzior	kędziorek
kęs	kęsik
kotek	kicia
kicia	kiciunia
kotek	kiciuś
kiecka	kiecuszka
kiełbasa	kiełbaska
kiełb	kiełbik
kieliszek	kieliszeczek
kielich	kieliszek
kiesa	kieska
kieszeń	kieszonka
kij	kijek
kikut	kikucik
kilim	kilimek
kisiel	kisielek
kiść	kistka
kiszka	kistka
kitel	kitelek
kita	kitka
kotek	kituś
kłaki	kłaczek
klacz	klaczka
kłamczuch	kłamczuszek
klamka	klameczka
klamerka	klamereczka
kłamstwo	kłamstewko
klan	klanik
klapka	klapeczka
klapa	klapka
klarnet	klarnecik
klasztor	klasztorek
klatka	klateczka
klątwa	klątewka
klatka	klatka
klawiatura	klawiaturka
kłąb	kłębuszek
kłębek	kłębuszek
klejnot	klejnocik
kleszcze	kleszczyki
klika	kliczka
klimat	klimacik
klin	klinek
klin	klinik
klisza	kliszka
kłobuk	kłobuczek
kloc	klocek
klocek	klocuszek
kłódka	kłódeczka
klomb	klombik
kłos	kłosek
kłos	kłosik
klosz	klosik
klosz	kloszyk
klub	klubik
klucz	kluczyk
kluska	kluseczka
kluski	kluseczki
kłus	kłusik
kminkówka	kminkóweczka
kmiot	kmiotek
knajpka	knajpeczka
knajpa	knajpka
knot	knocik
knot	knotek
knur	knurek
kobiałka	kobiałeczka
kobiecina	kobiecinka
kobieta	kobietka
kobita	kobitka
kobyła	kobyłka
kochanek	kochaneczek
kochanka	kochaneczka
kociak	kociaczek
kocię	kociątko
kocioł	kociołek
kocmołuch	kocmołuszek
kocur	kocurek
koc	kocyk
kok	koczek
koczkodan	koczkodanek
koczkodan	koczkodanik
kocz	koczyk
kodycyl	kodycylek
kod	kodzik
kogut	kogucik
kogut	kogutek
kojec	kojczyk
kokarda	kokardka
kokila	kokilka
kokon	kokonik
kokorycz	kokoryczka
kokota	kokotka
koks	koksik
kolacja	kolacyjka
kołacz	kołaczyk
kolano	kolanko
kolaska	kolaseczka
kolba	kolbka
kołchoźnica	kołchoźniczka
kołdra	kołderka
kolebka	kolebeczka
kołek	kołeczek
kółko	kółeczko
kolej	kolejka
kolekcja	kolekcyjka
koleżanka	koleżaneczka
kolega	koleżka
koliber	koliberek
koliba	kolibka
koło	kółko
kołnierz	kołnierzyk
kolonia	kolonijka
kolon	kolonik
kolor	kolorek
kolory	kolorki
kołowrót	kołowrotek
kołpak	kołpaczek
kolumna	kolumienka
kołyska	kołyseczka
kombinacja	kombinacyjka
kombinezon	kombinezonik
komcio	komciaczek
komediant	komediancik
komedia	komedyjka
komentarz	komentarzyk
kometa	kometka
komża	komeżka
komfort	komforcik
kominek	komineczek
komisja	komisyjka
komnata	komnatka
komoda	komódka
komórka	komóreczka
komora	komórka
kompania	kompanijka
kompilacja	kompilacyjka
komplet	komplecik
kompleks	kompleksik
komplement	komplemencik
kompot	kompocik
kompotiera	kompotierka
kompres	kompresik
komputer	komputerek
komunikat	komunikacik
komuch	komuszek
konar	konarek
koncept	koncepcik
koncepcja	koncepcyjka
koncert	koncercik
koncesja	koncesyjka
kondemnata	kondemnatka
kondensator	kondensatorek
kondycja	kondycyjka
konewka	koneweczka
konew	konewka
konflikt	konflikcik
koniak	koniaczek
konik	koniczek
koniczyna	koniczynka
koń	konik
koń na biegunach	konik na biegunach
koniugacja	koniugacyjka
koniec	koniuszczek
koniec	koniuszek
konkurs	konkursik
konsola	konsolka
konstytucja	konstytucyjka
kontakt	kontakcik
kontrakt	kontrakcik
kontusz	kontusik
konwalia	konwalijka
kopciuch	kopciuszek
kopiec	kopczyk
koperta	kopertka
kopuła	kopułka
kopyść	kopystka
kopyto	kopytko
koralik	koraliczek
koral	koralik
korba	korbka
kort	korcik
kordiał	kordiałek
kordon	kordonik
kord	kordzik
korek	koreczek
korepetycja	korepetycyjka
kornet	kornecik
koronka	koroneczka
korona	koronka
korpus	korpusik
korytarz	korytarzyk
koryto	korytko
korzeń	korzonek
kościół	kościołek
kościół	kościółek
kosmyk	kosmyczek
kostka	kosteczka
kostium	kostiumek
kostium	kostiumik
kość	kostka
kostur	kosturek
koszulka	koszuleczka
koszulina	koszulinka
koszula	koszulka
koszyk	koszyczek
kosz	koszyk
kotara	kotarka
kotek	koteczek
kotka	koteczka
kot	kotek
kotek	koteniek
koteria	koteryjka
kotew	kotewka
kotlet	kotlecik
kotlina	kotlinka
kotek	kotuś
kotwica	kotwiczka
kozak	kozaczek
kozik	koziczek
kozieł	koziełek
koziołek	koziołeczek
kozioł	koziołek
koza	kózka
koźlak	koźlaczek
koźlę	koźlątko
baran	kożuch
kożuch	kożuszek
kpina	kpinka
kraft	krafcik
kraj	kraik
krakowiak	krakowiaczek
Krakowiak	Krakowiaczek
kram	kramik
kran	kranik
krąp	krąpik
krasnal	krasnalek
krasnal	krasnoludek
kratka	krateczka
krata	kratka
kraty	kratki
krawat	krawacik
kreatura	kreaturka
kret	krecik
kredens	kredensik
kredyt	kredycik
krem	kremik
krepina	krepinka
kreska	kreseczka
krewniak	krewniaczek
kreza	krezka
krócica	króciczka
krok	kroczek
krokodyl	krokodylek
królewicz	królewiątko
królewicz	królewiczątko
królik	króliczek
król	królik
królowa	królówka
kromka	kromeczka
kropka	kropeczka
kropelka	kropeleczka
kropla	kropelka
kropeczka	kropeńka
kropidło	kropidełko
krosno	krosienko
krostka	krosteczka
krosta	krostka
krowa	krówka
krupa	krupka
krupnik	krupniczek
kruszyna	kruszynka
kryminał	kryminałek
kryminał	kryminalik
krynica	kryniczka
krynolina	krynolinka
kryształ	kryształek
kryształ	krysztalik
krzak	krzaczek
krzesło	krzesełko
krzesiwo	krzesiwko
krzew	krzewina
krzewina	krzewinka
krzyżyk	krzyżyczek
krzyż	krzyżyk
księstwo	ksiąstewko
książę	książątko
książka	książeczka
księga	książka
księgarnia	księgarenka
księgozbiór	księgozbiorek
księstwo	księstewko
księżulo	księżulek
księżulo	księżulko
ksiądz	księżunio
ksiądz	księżyk
kubek	kubeczek
kubek smakowy	kubeczek smakowy
kubeł	kubełek
kubrak	kubraczek
kucharka	kuchareczka
kuchta	kuchcik
kuchnia	kuchenka
kuciapa	kuciapka
kuc	kucyk
kudły	kudełki
kufel	kufelek
kuferek	kufereczek
kufer	kuferek
kujawiak	kujawiaczek
kukiełka	kukiełeczka
kukła	kukiełka
kukułka	kukułeczka
kulas	kulasek
kulka	kuleczka
kulfon	kulfonik
kula	kulka
kuma	kumoszka
kundel	kundelek
kupiec	kupczyk
kupka	kupeczka
kuper	kuperek
kupidyn	kupidynek
kupa	kupka
kuplet	kuplecik
kupon	kuponik
kurant	kurancik
kurczak	kurczaczek
kurczę	kurczątko
kurka	kureczka
kurwa	kurewka
kurhan	kurhanek
kurier	kurierek
kura	kurka
kurs	kursik
kurtka	kurteczka
kurtyna	kurtynka
kurytarz	kurytarzyk
kusztyk	kusztyczek
kutas	kutasek
kutas	kutasik
kutner	kutnerek
kuweta	kuwetka
kuzynek	kuzyneczek
kuzynka	kuzyneczka
kuzyn	kuzynek
kwadrat	kwadracik
kwadrans	kwadransik
kwartet	kwartecik
kwas	kwasek
kwaterka	kwatereczka
kwestia	kwestyjka
kwiaciarnia	kwiaciarenka
kwiatek	kwiateczek
kwiat	kwiatek
kwiatek	kwiatuszek
kwietnik	kwietniczek
kwitek	kwiteczek
kwit	kwitek
kwoka	kwoczka
kwota	kwotka
łabędź	łabądek
łabędź	łabędzik
łachman	łachmanek
łąka	łączka
lalka	laleczka
lala	lalka
lala	lalunia
lalka	lalusia
lalunia	lalusia
łamigłówka	łamigłóweczka
lama	lamka
lampa	lampeczka
lampka	lampeczka
lamus	lamusek
lamus	lamusik
łańcuch	łańcuszek
łan	łanek
łan	łanik
łapawica	łapawiczka
łapa	łapcia
łapka	łapeczka
łapa	łapina
łapina	łapinka
łapa	łapka
laptop	laptopik
lasek	laseczek
laska	laseczka
las	lasek
łasica	łasiczka
latarka	latareczka
latarnia	latarenka
łatka	łateczka
łata	łatka
lawina	lawinka
łazienka	łazieneczka
lazur	lazurek
łebek	łebeczek
łeb	łebek
legumina	leguminka
lej	lejek
lekcja	lekcyjka
lektura	lekturka
lemoniada	lemoniadka
leniuch	leniuszek
łepek	łepeczek
łeb	łepek
łepetyna	łepetynka
leszcz	leszczyk
lewar	lewarek
lewatywa	lewatywka
lew	lewek
leżak	leżaczek
łza	łezka
libacja	libacyjka
lichwa	lichewka
lichtarz	lichtarzyk
lico	liczko
liczydło	liczydełko
likier	likierek
lilia	lilijka
liliput	liliputek
limona	limonka
lipa	lipka
lira	lirenka
lira	lirka
list	liścik
lis	lisek
lisię	lisiątko
lisica	lisiczka
lisiura	lisiurka
listek	listeczek
liść bobkowy	listek bobkowy
liść laurowy	listek laurowy
liść	listek
listwa	listewka
litr	literek
litera	literka
lizak	lizaczek
łobuz	łobuzek
łobuziak	łobuziaczek
łobuz	łobuziak
lok	loczek
łódka	łódeczka
lód	lodek
łodyga	łodyżka
lód	lodzik
łojówka	łojóweczka
lokal	lokalik
łokieć	łokietek
lokomotywa	lokomotywka
lolita	lolitka
lont	loncik
łopatka	łopateczka
łopata	łopatka
łoś	łosik
łoszak	łoszaczek
locha	loszka
loteria	loteryjka
łotr	łotrzyk
lowelas	lowelasek
łóżko	łóżeczko
loża	lóżka
łuk	łuczek
łuczywo	łuczywko
lud	ludek
lufa	lufka
luj	lujek
luneta	lunetka
łupina	łupinka
lupa	lupka
lura	lurka
łuska	łuseczka
lusterko	lustereczko
lustro	lusterko
łuszczyna	łuszczynka
lutnia	luteńka
luz	luzik
lwię	lwiątko
łyk	łyczek
łyko	łyczko
łysina	łysinka
machina	machinka
maciora	maciorka
mak	maczek
mąka	mączka
madera	maderka
magazyn	magazynek
magierka	magiereczka
maglara	maglarka
magnes	magnesik
majątek	mająteczek
majdan	majdanek
majonez	majonezik
majtki	majteczki
makaron	makaronik
makata	makatka
makieta	makietka
makrela	makrelka
małość	maleńkość
malina	malinka
małolat	małolatek
małolata	małolatka
malowidło	malowidełko
małpka	małpeczka
małpię	małpiątko
małpa	małpka
maluch	maluszek
mama	mamusia
manela	manelka
mankament	mankamencik
mankiet	mankiecik
mansarda	mansardka
mantolet	mantolecik
mantyla	mantylka
manuskrypt	manuskrypcik
mapa	mapka
marchew	marchewka
marmelada	marmeladka
marmolada	marmoladka
marmur	marmurek
marynarka	marynareczka
marynata	marynatka
marzanka	marzaneczka
masaż	masażyk
maska	maseczka
masło	masełko
maślak	maślaczek
maszt	maszcik
maszyna	maszynka
matka	mateczka
mateczka	mateńka
materac	materacyk
mątwa	mątewka
matoł	matołek
matka	matula
matulka	matuleńka
matula	matulka
matka	matunia
matura	maturka
matula	matusia
matula	matuś
mazur	mazurek
mebel	mebelek
meczet	meczecik
mecz	meczyk
medalion	medalionik
melodia	melodyjka
mendel	mendelek
menuet	menuecik
metal	metalik
metryka	metryczka
mężatka	mężateczka
mężulo	mężulek
mąż	mężuś
mgiełka	mgiełeczka
mgła	mgiełka
miarka	miareczka
miara	miarka
miasto	miasteczko
miecz	mieczyk
miednica	miedniczka
miedziak	miedziaczek
mierzyn	mierzynek
mieścina	mieścinka
miesiąc	miesiączek
mięso	mięsko
mieszadło	mieszadełko
mieszczanka	mieszczaneczka
mieszczuch	mieszczuszek
miech	mieszek
mieszkanie	mieszkanko
mikrobus	mikrobusik
mikrofon	mikrofonik
mikrokryształ	mikrokryształek
mikrus	mikrusek
mikser	mikserek
mikstura	miksturka
miłostka	miłosteczka
minaret	minarecik
mineta	minetka
miniatura	miniaturka
mina	minka
minus	minusik
minuta	minutka
miotła	miotełka
miska	miseczka
misiak	misiaczek
mizerak	mizeraczek
młodzian	młodzianek
młodzieniec	młodzieniaszek
młokos	młokosik
młotek	młoteczek
młot	młotek
młynarka	młynareczka
młynek	młyneczek
mniszek pospolity	mniszeczek
mniszka	mniszeczka
mobil	mobilek
model	modelik
modrak	modraczek
mogiła	mogiłka
moment	momencik
moneta	monetka
monument	monumencik
mops	mopsik
mordka	mordeczka
morda	mordka
morda	morduchna
morus	morusek
most	mościk
mostek	mosteczek
most	mostek
motet	motecik
motek	moteczek
motor	motorek
motyl	motylek
motyw	motywik
mowa	mówka
mózg	móżdżek
moździerz	moździerzyk
mrówka	mróweczka
mróz	mrozek
mróz	mrozik
mszał	mszalik
muchomor	muchomorek
mufa	mufka
mundur	mundurek
munsztuk	munsztuczek
mur	murek
Murzyn	Murzynek
mus	musik
muszka	muszeczka
muszla	muszelka
mucha	muszka
muszkatela	muszkatelka
mutra	muterka
muzyka	muzyczka
muzykant	muzykancik
mydło	mydełko
myśl	myślątko
myszka	myszeczka
mysz	myszka
naczynie	naczynko
naczynie	naczyńko
nadzienie	nadzionko
nagus	nagusek
namiętność	namiętnostka
namiot	namiocik
naparstek	naparsteczek
naród	narodek
narzędzie	narządko
nasada	nasadka
nasiono	nasionko
nać	natka
natręt	natręcik
natura	naturka
negliż	negliżyk
nektaryna	nektarynka
nerka	nereczka
neseser	neseserek
niebieski ptak	niebieski ptaszek
nieborak	nieboraczek
niebożę	niebożątko
niecka	niecułka
niedźwiedź	niedźwiadek
niedźwiedź polarny	niedźwiadek polarny
niegrzeczność	niegrzecznostka
Niemiec	Niemiaszek
niemowlak	niemowlaczek
niemowlę	niemowlątko
nieporządek	nieporządeczek
nieprzyjemność	nieprzyjemnostka
nimfomanka	nimfetka
nitka	niteczka
nić	nitka
niuans	niuansik
nochal	nochalek
noc	nocka
nocnik	nocniczek
noob	noobek
nora	norka
nosek	noseczek
nos	nosek
notatka	notateczka
notes	notesik
nowela	nowelka
nowina	nowinka
nóżka	nóżeczka
noga	nózia
noga	nóżka
nożyce	nożyczki
nóż	nożyk
noga	nożyna
nożyna	nożynka
numerek	numereczek
numer	numerek
nuta	nutka
obarzanek	obarzaneczek
obcas	obcasik
oberek	obereczek
obiad	obiadek
obietnica	obietniczka
obejma	objemka
obłam	obłamek
obława	obławka
obłok	obłoczek
obora	obórka
obręb	obrąbek
obrazek	obrazeczek
obraz	obrazek
obręb	obrębek
obroża	obróżka
obrus	obrusek
obrus	obrusik
obryw	obrywek
obrzęd	obrządek
obrzyn	obrzynek
obuch	obuszek
ocena	ocenka
ochłap	ochłapek
ochota	ochotka
oko	ocio
ociupina	ociupinka
oczko	oczątko
oko	oczko
odcinek	odcineczek
oddział	oddziałek
odłam	odłamek
odmiana	odmianka
odnoga	odnóżka
odpad	odpadek
odrobinka	odrobineczka
odrobina	odrobinka
oficer	oficerek
oficyna	oficynka
ogar	ogarek
ogień	ogienek
ogieniek	ogieniaszek
ogień	ogieniek
ogier	ogierek
ogniwo	ogniwko
ogórek	ogóreczek
ogródek	ogródeczek
ogród	ogródek
ogrodnik	ogrodniczek
ojciec	ojcaszek
ojciec	ojczulek
ojciec	ojczuś
okazja	okazyjka
okno	okieneczko
okno	okienko
okiennica	okienniczka
okólnik	okólniczek
okręt	okręcik
okruch	okruszek
okruszyna	okruszynka
okrywa	okrywka
okrzos	okrzosek
okulary	okularki
olej	olejek
oleodruk	oleodruczek
ołówek	ołóweczek
olstro	olsterko
olszyna	olszynka
ołtarz	ołtarzyk
omlet	omlecik
onuca	onucka
onuca	onuczka
operacja	operacyjka
opona	oponka
opowiadanie	opowiadanko
opowieść	opowiastka
oprawa	oprawka
order	orderek
organ	organek
orlę	orlątko
oryginał	oryginalik
orzech	orzeszek
osioł	osiołek
oślica	ośliczka
osłona	osłonka
ośmiornica	ośmiorniczka
osoba	osóbka
ostew	ostewka
ostrew	ostrewka
ostrów	ostrówek
ostróżka	ostróżeczka
otomana	otomanka
otręby	otrąbki
otwór	otworek
owad	owadek
owca	owieczka
owies	owiesek
owoc	owocek
ozdoba	ozdóbka
ozimina	oziminka
ozór	ozorek
pacholę	pacholątko
pachoł	pachołek
pacierz	paciorek
pacyfa	pacyfka
pąk	pączek
pączek	pączuszek
paczka	paczuszka
pagórek	pagóreczek
pajac	pajacyk
pająk	pajączek
pajda	pajdka
pajęczyna	pajęczynka
pakiet	pakiecik
pakunek	pakuneczek
pałac	pałacyk
pałąk	pałączek
pałka	pałeczka
palma	palemka
paleta	paletka
palto	paletko
pal	palik
pała	pałka
paltko	palteczko
palto	paltko
paltot	paltocik
palec	paluszek
paluch	paluszek
pamiątka	pamiąteczka
pamiętnik	pamiętniczek
pampuch	pampuszek
pancerz	pancerzyk
pan	panek
panew	panewka
panicz	paniczyk
panienka	panieneczka
panna	panienka
pani	paniusia
państwo	państewko
pantalony	pantalonki
pantera	panterka
pantofel	pantofelek
papa	papcio
papier	papierek
papieros	papierosek
papieros	papierosik
papilot	papilotek
papryka chili	papryczka chili
papryka	papryczka
papuć	paputek
papuga	papużka
paragon	paragonik
parapet	parapecik
parasol	parasolik
parasza	paraszka
parawan	parawanik
parcela	parcelka
park	parczek
parkan	parkanik
para	parka
parobek	parobeczek
parostatek	parostateczek
parówka	paróweczka
parów	parowek
parownica	parowniczka
parowóz	parowozik
partanina	partaninka
partia	partyjka
pasek	paseczek
pas	pasek
pasmo	pasemko
pasieka	pasieczka
pasterka	pastereczka
pastuch	pastuszek
pacha	paszka
paszport	paszporcik
pasztet	pasztecik
patelnia	patelenka
patelnia	patelka
patent	patencik
patologia	patolka
patyk	patyczek
paw	pawik
pawilon	pawilonik
paź	pazik
paznokieć	paznokietek
pazur	pazurek
pchła	pchełka
pęcherz	pęcherzyk
pęk	pęczek
pedant	pedancik
pędrak	pędraczek
pędzel	pędzelek
pedał	pedzio
pejcz	pejczyk
pejzaż	pejzażyk
peleryna	pelerynka
pelikan	pelikanik
pelota	pelotka
peniuar	peniuarek
pens	pensiak
pensjonat	pensjonacik
pensjonarka	pensjonareczka
pensja	pensyjka
pepik	pepiczek
Pepik	Pepiczek
pępek	pępuszek
perła	perełka
perły	perełki
perfumy	perfumki
perkalik	perkaliczek
peruka	peruczka
perz	perzyk
pęseta	pęsetka
pestka	pesteczka
petarda	petardka
pętla	pętelka
piana	pianka
piasek	piaseczek
piąstka	piąsteczka
pięść	piąstka
picza	piczka
pidżama	pidżamka
piegus	piegusek
piekarnia	piekarenka
pielucha	pieluszka
pieniądz	pieniążek
pień	pieniek
pieprz	pieprzyk
pierdoła	pierdółka
piernik	pierniczek
pieróg	pierożek
pierścionek	pierścioneczek
pierścień	pierścionek
piersi	piersiątka
pierś	piersiątko
pierś	piersiczka
piersi	piersiczki
pierwszak	pierwszaczek
pierzyna	pierzynka
pieścidło	pieścidełko
piesek	pieseczek
pies	piesek
pies	piesio
pieszczoch	pieszczoszek
pieszczota	pieszczotka
piętro	pięterko
pięta	piętka
pigułka	pigułeczka
piguła	pigułka
pijak	pijaczek
piłka	piłeczka
piła	piłka
piłkarz	piłkarzyk
pilnik	pilniczek
pilot	pilocik
pinceta	pincetka
pinczer	pinczerek
pingwin	pingwinek
pionek	pion
piórko	pióreczko
pióro	piórko
piórnik	piórniczek
piosenka	pioseneczka
pieśń	piosenka
piosnka	piosneczka
pipa	pipcia
pipa	pipka
piramida	piramidka
piruet	piruecik
pisanka	pisaneczka
pismo	pisemko
pisklę	pisklątko
pismak	pismaczek
pistolet	pistolecik
piszczałka	piszczałeczka
piwo	piwko
piwnica	piwniczka
piżama	piżamka
płacheć	płachetek
płachta	płachetka
placek	placuszek
plac	placyk
plakat	plakacik
plamka	plameczka
plama	plamka
plaster	plasterek
płaszcz	płaszczyk
płatek	płateczek
płat	płatek
platforma	platforemka
pława	pławka
plecak	plecaczek
plecionka	plecioneczka
plecy	plecki
pled	pledzik
płetwa	płetewka
plik	pliczek
plisa	pliska
płótno	płócienko
płomyk	płomyczek
płomień	płomyk
płonka	płoneczka
płot	płotek
plotkarka	plotkareczka
płuco	płucko
pludry	pluderki
plus	plusik
pług	płużek
płyta	płytka
pływak	pływaczek
pniak	pniaczek
pochwa	pochewka
pochód	pochodzik
pociąg	pociążek
pociot	pociotek
podanie	podanko
podarek	podareczek
podarunek	podaruneczek
podkówka	podkóweczka
podkowa	podkówka
podłość	podłostka
podmiana	podmianka
podmuch	podmuszek
podpora	podpórka
podstawa	podstawka
poduszka	poduszeczka
podwiązka	podwiązeczka
podwórko	podwóreczko
poemat	poemacik
pogaducha	pogaduszka
pogląd	poglądzik
pogoda	pogódka
poidło	poidełko
pojemnik	pojemniczek
pojnik	pojniczek
pokojówka	pokojóweczka
pokrywa	pokrywka
Polak	Polaczek
polana	polanka
polano	polanko
półbut	półbucik
polka	poleczka
półka	półeczka
polędwica	polędwiczka
poler	polerek
pole	poletko
polewka	poleweczka
półgłos	półgłosek
półgodzina	półgodzinka
półgrosz	półgroszek
polityka	polityczka
półkolumna	półkolumienka
pole	pólko
polonez	polonezik
polowanie	polowanko
półpiętro	półpięterko
półsłówko	półsłóweczko
półuśmiech	półuśmieszek
półwałek	półwałeczek
pomada	pomadka
pomarańcza	pomarańczka
pomidor	pomidorek
pomnik	pomniczek
pomost	pomostek
pompa	pompka
pompon	pomponik
pończocha	pończoszka
portki	porcięta
port	porcik
porcja	porcyjka
portal	portalik
portasy	portaski
portki	porteczki
porter	porterek
portfel	portfelik
portrecik	portreciczek
portret	portrecik
porucznik	poruczniczek
porządek	porządeczek
posada	posadka
posag	posażek
posąg	posążek
pościelówa	pościelówka
posesja	posesyjka
posmak	posmaczek
postawa	postawka
postronek	postroneczek
postument	postumencik
postura	posturka
poszewka	poszeweczka
poszwa	poszewka
potrzeba	potrzebka
powidło	powidełko
powiedzenie	powiedzonko
powłoka	powłoczka
powóz	powozik
powrósło	powrósełko
pożar	pożarek
pozłota	pozłotka
pozytyw	pozytywik
prababka	prababcia
pradziad	pradziadek
prąd	prądzik
pranie	pranko
prapradziad	prapradziadek
prasa	praska
prątek	prąteczek
prawidło	prawidełko
prawnuk	prawnuczek
precel	precelek
preferans	preferansik
pretensja	pretensyjka
prezent	prezencik
próbka	próbeczka
próba	próbka
problemat	problemacik
problem	problemik
procent	procencik
proces	procesik
program	programik
projekt	projekcik
prom	promik
promień	promionek
promyk	promyczek
promień	promyk
prosiak	prosiaczek
prosię	prosiątko
prostak	prostaczek
prostokąt	prostokącik
protekcja	protekcyjka
protokół	protokolik
protokół	protokólik
prowizja	prowizyjka
próg	prożek
pryszcz	pryszczyk
prząśnica	prząśniczka
przebudowa	przebudówka
przedmiot	przedmiocik
przedmowa	przedmówka
przedpokój	przedpokoik
przedszkolak	przedszkolaczek
przegroda	przegródka
przełęcz	przełączka
przemowa	przemówka
przepiórka	przepióreczka
przepita	przepitka
przepoja	przepojka
prześcieradło	prześcieradełko
przesyłka	przesyłeczka
przewód	przewodzik
przyczepa	przyczepka
przydach	przydaszek
przygoda	przygódka
gródek	przygródek
przyjaciółka	przyjaciółeczka
przyjemność	przyjemnostka
przykład	przykładzik
przykrywa	przykrywka
przylepka	przylepeczka
przylepa	przylepka
przyrząd	przyrządzik
przysiad	przysiadek
przystanek	przystaneczek
przystojniak	przystojniaczek
przytulia	przytulijka
psiak	psiaczek
psina	psinka
psina	psiunia
pstrąg	pstrążek
pszczoła	pszczółka
pszenica	pszeniczka
ptaszę	ptaszątko
ptaszek	ptaszeczek
ptak	ptaszek
ptak	ptaszyna
ptaszyna	ptaszynka
ptifury	ptifurki
publika	publiczka
puchar	pucharek
puca	pucka
pucka	pućka
pudełko	pudełeczko
pudel	pudelek
pukiel	pukielek
pulares	pularesik
pulower	pulowerek
pulpet	pulpecik
punkt	punkcik
pupa	pupcia
pupka	pupeczka
pupil	pupilek
pupa	pupina
pupa	pupka
pustułka	pustułeczka
puszka	puszeczka
puch	puszek
puzdro	puzderko
pychota	pychotka
pyra	pyrka
pysk	pysio
pysk	pyszczek
pytanie	pytanko
pyta	pytka
rabat	rabacik
rabata	rabatka
rachunek	rachuneczek
racica	raciczka
racuch	racuszek
rak	raczek
ręka	rączka
rączka	rączuchna
rak	raczyna
ręka	rączyna
radio	radyjko
rafa	rafka
rajstopy	rajstopki
rakieta	rakietka
ramka	rameczka
ramię	ramionko
rama	ramka
ramota	ramotka
rant	rancik
rana	ranka
raptularz	raptularzyk
rarytas	rarytasik
ratler	ratlerek
recenzja	recenzyjka
ręcznik	ręczniczek
reduta	redutka
refektarz	refektarzyk
reflektor	reflektorek
regał	regalik
reguła	regułka
rejestr	rejestrzyk
rejs	rejsik
rękaw	rękawek
reklama	reklamka
remanent	remanencik
remis	remisik
remont	remoncik
reportaż	reportażyk
restauracja	restauracyjka
reszta	resztka
rewers	rewersik
rewolucja	rewolucyjka
rezydencja	rezydencyjka
robak	robaczek
rober	roberek
robot	robocik
rodzina	rodzinka
rogal	rogalik
rogoża	rogóżka
rój	roik
rolada	roladka
roleta	roletka
rola	rólka
romans	romansik
rondel	rondelek
rondo	rondko
ropucha	ropuszka
roślina	roślinka
rosół	rosołek
rotunda	rotundka
rower	rowerek
równina	równinka
rozdział	rozdziałek
rozdział	rozdzialik
rózga	różdżka
rózga	rózeczka
róg	rożek
róg	różek
rozeta	rozetka
rozkaz	rozkazik
rozmowa	rozmówka
rozprawa	rozprawka
rozróba	rozróbka
rozsada	rozsadka
rozum	rozumek
rozwora	rozwórka
róża	różyczka
rubel	rubelek
rubryka	rubryczka
rudera	ruderka
ruda	rudka
rulon	rulonik
rum	rumik
runda	rundka
rurka	rureczka
rura	rurka
rusałka	rusałeczka
ruta	rutka
rybka	rybcia
rybka	rybeczka
rybka	rybeńka
ryba	rybka
rycerz	rycerzyk
rydel	rydelek
ryj	ryjek
rynek	ryneczek
rynka	ryneczka
rynna	rynienka
rysunek	rysuneczek
rząd	rządek
rzeka	rzeczka
rzeczka	rzeczułka
rzemyk	rzemyczek
rzemień	rzemyk
rzepa	rzepka
rzęsa	rzęska
rzeżucha	rzeżuszka
sadło	sadełko
sadzawka	sadzaweczka
sagan	saganek
sakwa	sakiewka
sala	salka
salopa	salopka
samiec	samczyk
samica	samiczka
samochód	samochodzik
samolot	samolocik
samura	samurka
sandał	sandałek
sanki	saneczki
sardela	sardelka
sarna	sarenka
sarnię	sarniątko
scena	scenka
schab	schabik
schemat	schemacik
schody	schodki
ściana	ścianka
ścierka	ściereczka
ścieżka	ścieżeczka
ścieg	ścieżek
ścieżyna	ścieżynka
scyzoryk	scyzoryczek
seans	seansik
set	secik
sęk	sęczek
segment	segmencik
sekret	sekrecik
sekunda	sekundka
sensacja	sensacyjka
serdak	serdaczek
serce	serduszko
ser	serek
sernik	serniczek
serwetka	serweteczka
serweta	serwetka
seria	seryjka
sesja	sesyjka
setka	seteczka
setka	setuchna
siano	sianko
siatka	siateczka
sieć	siatka
siekanina	siekaninka
sielawa	sielawka
siennik	sienniczek
siermięga	siermiężka
sierota	sieroteńka
sierota	sierotka
sierp	sierpik
siewnik	siewniczek
sikorka	sikoreczka
silnik	silniczek
siniak	siniaczek
sień	sionka
siostra	siostrunia
siostra	siostrzyczka
siur	siurek
siurpryza	siurpryzka
siwosz	siwoszek
skafander	skafanderek
skakanka	skakaneczka
skała	skałka
skandal	skandalik
skarbiec	skarbczyk
skarbek	skarbeczek
skarb	skarbek
skarbek	skarbeniek
skarb	skarbik
skarbek	skarbulek
skarpetka	skarpeteczka
skecz	skeczyk
skiba	skibka
skra	skierka
skład	składzik
skobel	skobelek
skop	skopek
skórka	skóreczka
skóra	skórka
skorpion	skorpionik
skorupa	skorupka
skowronek	skowroneczek
skrawek	skraweczek
skrzat	skrzacik
skrzat	skrzatek
skrzek	skrzeczek
skrzela	skrzelka
skrzydło	skrzydełko
skrzynka	skrzyneczka
skrzynia	skrzynka
skrzypki	skrzypeczki
skrzypce	skrzypki
skuter	skuterek
skwer	skwerek
słabiak	słabiaczek
słabość	słabostka
śledź	śledzik
ślepek	ślepeczek
ślimak	ślimaczek
ślina	ślinka
slipy	slipki
śliwka	śliweczka
śliwa	śliwka
słoik	słoiczek
słonko	słoneczko
słonica	słoniczka
słoń	słonik
słonina	słoninka
słońce	słonko
Słońce	słonko
słówko	słóweczko
słowo	słówko
słownik	słowniczek
słuchawka	słuchaweczka
słup	słupek
smak	smaczek
śmiechawka	śmiechaweczka
śmiechawa	śmiechawka
śmiechówka	śmiechóweczka
śmiechówa	śmiechówka
śmiech	śmieszek
śmietanka	śmietaneczka
smok	smoczek
smród	smrodek
smród	smrodzik
smutek	smuteczek
smuga	smużka
śniadanie	śniadanko
śnieg	śnieżek
snopek	snopeczek
sok	soczek
soft	sofcik
soft porno	sofcik
sofa	sofka
solara	solarka
soliter	soliterek
rzodkiew sopel lodu	sopelek
sopel	sopelek
sosna	sosenka
sos	sosik
sośnina	sośninka
socha	soszka
sówka	sóweczka
sowa	sówka
spacer	spacerek
spaliny	spalinki
spam	spamik
specjał	specjałek
specjał	specjalik
spekulacja	spekulacyjka
speluna	spelunka
spencer	spencerek
spichlerz	spichlerzyk
śpiewnik	śpiewniczek
spinka	spineczka
śpioch	śpioszek
śpiochy	śpioszki
spirala	spiralka
śpiwór	śpiworek
spiżarka	spiżarenka
spiżarnia	spiżarka
spłacheć	spłachetek
spodek	spodeczek
spodnie	spodeńki
spódnica	spódniczka
spółka	spółeczka
sprawka	spraweczka
sprawozdanie	sprawozdanko
sprężyna	sprężynka
spryciara	spryciarka
spryt	sprycik
spryciula	spryciulka
sprzęt	sprzęcik
sroka	sroczka
środek	środeczek
śrubka	śrubeczka
śruba	śrubka
stacja	stacyjka
stadion	stadionik
stągiew	stągiewka
stajnia	stajenka
stancja	stancyjka
standard	standardzik
stanik	staniczek
starowina	starowinka
staruszek	staruszeczek
staruszka	staruszeczka
stary	staruszek
statek	stateczek
statua	statuetka
statyw	statywik
staw	stawek
staw	stawik
stempel	stempelek
sterta	stertka
stok	stoczek
stodoła	stodółka
stojak	stojaczek
stołek	stołeczek
stolik	stoliczek
stolnica	stolniczka
stopka	stopeczka
stopień	stopieniek
stopa	stopka
stopa	stópka
stos	stosik
stówka	stóweczka
stówa	stówka
strąk	strączek
stragan	straganik
straszydło	straszydełko
stres	stresiak
stres	stresik
strofa	strofka
strój	stroik
strona	stroniczka
strucla	strucelka
strumień	strumyk
struna	strunka
strup	strupek
struga	strużka
stryj	stryjek
stryjna	stryjenka
stryjo	stryjko
strych	stryszek
strzałka	strzałeczka
strzała	strzałka
strzelba	strzelbka
strzemię	strzemionko
strzęp	strzępek
student	studencik
studnia	studzienka
stwór	stworek
stworzenie	stworzątko
stworzenie	stworzonko
stylisko	stylik
substancja	substancyjka
suchar	sucharek
suka	suczka
sukces	sukcesik
sukcesja	sukcesyjka
sukienka	sukieneczka
sukno	sukienko
sukienka	sukienusia
sukmana	sukmanka
sum	sumik
suma	sumka
suka	sunia
supeł	supełek
surdut	surducik
sutanna	sutanka
suwak	suwaczek
sweter	sweterek
światełko	światełeczko
światło	światełko
świątynia	świątynka
świątynia	świątyńka
świerk	świerczek
świerszcz	świerszczyk
świetlik	świetliczek
świetlica	świetliczka
świnka	świneczka
świnia	świnka
świństwo	świństewko
syf	syfek
sygnał	sygnałek
symultana	symultanka
synek	syneczek
syn	synek
syrena	syrenka
syrop	syropek
system	systemik
szabla	szabelka
szaber	szaberek
szablon	szablonik
szacunek	szacuneczek
szafarka	szafareczka
szafka	szafeczka
szafir	szafirek
szafa	szafka
szałas	szałasik
szalik	szaliczek
szala	szalka
szalupa	szalupka
szama	szamka
szaniec	szańczyk
szantaż	szantażyk
szarak	szaraczek
szatan	szatanek
szata	szatka
szczapa	szczapka
szczaw	szczawik
szczebel	szczebelek
szczecina	szczecinka
szczegół	szczególik
szczelina	szczelinka
szczeniak	szczeniaczek
szczenię	szczeniątko
szczotka	szczoteczka
szczupak	szczupaczek
szczur	szczurek
szczygieł	szczygiełek
szczypce	szczypczyki
szczypior	szczypiorek
szef	szefuńcio
szef	szefunio
szeląg	szelążek
szelka	szeleczka
szept	szepcik
sześcian	sześcianik
szewc	szewczyk
szew	szewek
szkapa	szkapka
szkatułka	szkatułeczka
szkielet	szkielecik
szklanka	szklaneczka
szkoła	szkółka
szkop	szkopek
szkrab	szkrabek
szkrab	szkrabik
szlaban	szlabanik
szlachcianka	szlachcianeczka
szlak	szlaczek
szlafrok	szlafroczek
szlam	szlamik
szlara	szlarka
szlemik	szlemiczek
szlem	szlemik
szmatka	szmateczka
szmata	szmatka
szmer	szmerek
sznurek	sznureczek
sznur	sznurek
sznycel	sznycelek
sznyta	sznytka
szpachla	szpachelka
szpak	szpaczek
szpadel	szpadelek
szpada	szpadka
szpadryna	szpadrynka
szpaler	szpalerek
szparka	szpareczka
szpargał	szpargałek
szpargał	szpargalik
szpara	szparka
szpilka	szpileczka
szpinak	szpinaczek
szpital	szpitalik
szpryca	szprycka
szpulka	szpuleczka
szron	szronik
sztab	sztabik
sztaba	sztabka
sztacheta	sztachetka
sztajer	sztajerek
sztambuch	sztambuszek
sztos	sztosik
sztucer	sztucerek
sztyft	sztyfcik
sztylet	sztylecik
szuflada	szufladka
szum	szumek
szwaczka	szwaczusia
szwadron	szwadronik
szwagierka	szwagiereczka
szwagier	szwagierek
szwindel	szwindelek
szyba	szybka
szyfoniera	szyfonierka
szyja	szyjka
szynk	szynczek
szynka	szyneczka
szynkarka	szynkareczka
szypuła	szypułka
szyszka	szyszeczka
szycha	szyszka
tabakierka	tabakiereczka
tabakiera	tabakierka
tabela	tabelka
tablica	tabliczka
taboret	taborecik
taca	tacka
tafla	tafelka
taksówka	taksóweczka
talent	talencik
talerz	talerzyk
tambur	tamburek
tampon	tamponik
tapczan	tapczanik
tapir	tapirek
taras	tarasik
tarcica	tarciczka
tarcza	tarczka
tarka	tareczka
tartak	tartaczek
tasiemka	tasiemeczka
taśma	tasiemka
tata	tatka
tato	tatko
tata	tatuś
tato	tatuś
tawuła	tawułka
teatr	teatrzyk
techniawa	techniawka
teczka	teczuszka
tekst	tekścik
tektura	tekturka
telefon	telefonik
telewizor	telewizorek
temat	temacik
temperament	temperamencik
tendencja	tendencyjka
tenor	tenorek
teoria	teoryjka
terminarz	terminarzyk
termos	termosik
test	teścik
tętnica	tętniczka
tłok	tłoczek
tłuk	tłuczek
tłum	tłumek
tłumok	tłumoczek
tłuścioch	tłuścioszek
tłuszcz	tłuszczyk
toast	toaścik
tok	toczek
tom	tomik
topola	topolka
tort	torcik
torebka	torebeczka
torba	torebka
traktat	traktacik
traktor	traktorek
trans	transik
transparent	transparencik
transporter	transporterek
tranzystor	tranzystorek
trap	trapik
tratwa	tratewka
trawka	traweczka
trawa	trawka
trawnik	trawniczek
trefl	trefelek
trep	trepek
trójka	trójeczka
trójkąt	trójkącik
trójnóg	trójnóżek
tron	tronik
trucht	truchcik
truchło	truchełko
trufla	trufelka
trumna	trumienka
trumniak	trumniaczek
trup	trupek
trusia	trusiątko
truskawka	truskaweczka
tryb	trybik
trybula	trybulka
trykot	trykocik
tryper	trynio
trzaska	trzaseczka
trzcinnik	trzcinniczek
trzeciak	trzeciaczek
trzewik	trzewiczek
trzonek	trzoneczek
trzos	trzosik
trzpiot	trzpiotek
tuleja	tulejka
tulipan	tulipanek
tunika	tuniczka
tupet	tupecik
turban	turbanek
turbina	turbinka
turczyn	turczynek
Turczyn	Turczynek
turkawka	turkaweczka
turkus	turkusik
turnia	turniczka
tusza	tuszka
tużurek	tużureczek
twaróg	twarożek
twarz	twarzyczka
tygiel	tygielek
tygodnik	tygodniczek
tygrys	tygrysek
tygrysię	tygrysiątko
tyłek	tyłeczek
typ	typek
tyraliera	tyralierka
tyran	tyranek
tysiąc	tysiączek
tysiak	tysiaczek
tysiąc	tysiak
tytuł	tytulik
ubiór	ubiorek
ubranie	ubranko
ugór	ugorek
układ	układzik
ukleja	uklejka
ukłon	ukłonik
ulica	uliczka
uparciuch	uparciuszek
upłaz	upłazek
uprzejmość	uprzejmostka
uraz	urazik
urlop	urlopik
urodziny	urodzinki
urwis	urwisek
urzyn	urzynek
usta	usteczka
ustęp	ustępik
ucho	uszko
utwór	utworek
uwaga	uważka
uzda	uzdeczka
wachlarz	wachlarzyk
wądół	wądołek
wafel	wafelek
wahadło	wahadełko
walc	walczyk
wałek	wałeczek
wał	wałek
walizka	walizeczka
waliza	walizka
wampir	wampirek
wanienka	wanieneczka
wanna	wanienka
warchlak	warchlaczek
wariat	wariatuńcio
warkocz	warkoczyk
warstwa	warstewka
warsztat	warsztacik
wąs	wąsik
wata	watka
Wawa	Wawka
wąwóz	wąwozik
waza	wazka
wazon	wazonik
wdówka	wdóweczka
wdowa	wdówka
wędlina	wędlinka
wędrownik	wędrowniczek
wędzonka	wędzoneczka
węgar	węgarek
węgiel	węgielek
węgrzyn	węgrzynek
wełna	wełenka
wełniak	wełniaczek
wełnianka	wełnianeczka
welon	welonik
wentylator	wentylatorek
weranda	werandka
westa	westka
węzeł	węzełek
wezgłowie	wezgłówek
wąż	wężyk
wiadro	wiaderko
wianek	wianeczek
wianek	wianuszek
wiatr	wiaterek
wiatrak	wiatraczek
wiązadło	wiązadełko
wiązka	wiązeczka
wicher	wicherek
widelec	widelczyk
widły	widełki
więcierz	więciorek
wieczór	wieczorek
wielbłąd	wielbłądek
wieprz	wieprzak
wieprz	wieprzek
wieprzowina	wieprzowinka
wierszyk	wierszyczek
wiersz	wierszyk
wierzba	wierzbka
wieśniak	wieśniaczek
wieszak	wieszaczek
wiatr	wietrzyk
wiewiórka	wiewióreczka
więzadło	więzadełko
wieża obserwacyjna	wieżyczka obserwacyjna
wieża	wieżyczka
wilczę	wilczątko
wilk	wilczek
winiarnia	winiarenka
winieta	winietka
wino	winko
wiórek	wióreczek
wioska	wioseczka
wiosna	wiosenka
wirydarz	wirydarzyk
wist	wiścik
wiśnia	wisienka
wiśniówka	wiśnióweczka
wiszor	wiszorek
witamina	witaminka
witryna	witrynka
wizawa	wizawka
włókno	włókienko
włosek	włoseczek
włos	włosek
włosy	włosięta
wnuk	wnuczek
wnuczek	wnuczuś
wnuczka	wnusia
wódka	wódeczka
wodnik	wodniczek
wodospad	wodospadzik
wódka	wódzia
wojaż	wojażyk
wojna	wojenka
wół	wołek
wołowina	wołowinka
worek	woreczek
wózek	wózeczek
wóz	wózek
wóz	wozik
wróbel	wróbelek
Wrocław	Wrocek
wrzeciono	wrzecionko
wrzód	wrzodzik
wstążka	wstążeczka
wstęga	wstążka
wstręciuch	wstręciuszek
wstręciucha	wstręciuszka
wujek	wujaszek
wujko	wujcio
wuj	wujek
wujenka	wujeneczka
wujna	wujenka
wujo	wujko
wulkanizator	wulkanizatorek
wurst	wurścik
wybryk	wybryczek
wydatek	wydateczek
wydra	wyderka
wykład	wykładzik
wykres	wykresik
wypadek	wypadeczek
wyprawa	wyprawka
wyraz	wyrazik
wyspa	wysepka
wytrych	wytryszek
wytwórnia	wytwórenka
wywiad	wywiadzik
wyżeł	wyżełek
wyziew	wyziewek
wyżyna	wyżynka
wzgórek	wzgóreczek
wzmianka	wzmianeczka
wzór	wzorek
wzrok	wzroczek
zabawka	zabaweczka
ząbek	ząbeczek
ząb	ząbek
żaba	żabka
żabot	żabocik
żak	żaczek
zadatek	zadateczek
żądło	żądełko
zaduch	zaduszek
zadzior	zadziorek
żagiel	żagielek
zagon	zagonek
zagon	zagonik
zagroda	zagródka
zając	zajączek
żakiet	żakiecik
zakład	zakładzik
zakonnica	zakonniczka
zakręt	zakręcik
zakupy	zakupki
żal	żalik
załom	załomek
żaluzja	żaluzyjka
zamek	zameczek
zapałka	zapałeczka
zapas	zapasik
zapita	zapitka
zapoja	zapojka
żart	żarcik
żardyniera	żardynierka
żarcie	żarełko
żarło	żarełko
żarówka	żaróweczka
żarówa	żarówka
zasłona	zasłonka
zasobnik	zasobniczek
zasuwa	zasuwka
zatoka	zatoczka
zawał	zawalik
zawias	zawiasek
zawijas	zawijasek
zawór	zaworek
zazula	zazulka
zbiór	zbiorek
zbiornik	zbiorniczek
zbir	zbirek
zbłąkana owca	zbłąkana owieczka
zbójnik	zbójniczek
zdanie	zdanko
zdechlak	zdechlaczek
zdjęcie	zdjątko
zdrówko	zdróweczko
zdrowie	zdrówko
ździebełko	ździebełeczko
źdźbło	ździebełko
ździebko	ździebełko
żebro	żeberko
zefir	zefirek
zegarek	zegareczek
żeleźniak	żeleźniaczek
żerdź	żerdka
zestaw	zestawik
zeszyt	zeszycik
zgred	zgredek
zgryzota	zgryzotka
zgrzyt	zgrzycik
ziarno	ziarenko
ziarnko	ziarneczko
ziarno	ziarnko
ziarnko	ziarnuszko
zieleniak	zieleniaczek
zielenina	zieleninka
ziemniak	ziemniaczek
ziółko	ziółeczko
zioła	ziółka
zioło	ziółko
ziom	ziomek
ziomek	ziomuś
żleb	żlebek
żleb	żlebik
żłobek	żłobeczek
żłóbek	żłóbeczek
żłób	żłobek
żłób	żłóbek
złodziej	złodziejaszek
złośliwość	złośliwostka
zmiana	zmianka
żmija	żmijka
znak	znaczek
znajomy	znajomek
znamię	znamionko
żołądek	żołądeczek
żołnierz	żołnierzyk
żółw	żółwik
żonka	żoncia
żonka	żoneczka
żona	żonka
żonkil	żonkilek
zrąb	zrąbek
zraz	zrazik
źrebak	źrebaczek
źrebię	źrebiątko
źrebiec	źrebiczek
źrebica	źrebiczka
źródło	źródełko
zrost	zrostek
żubr	żubrek
żuk	żuczek
żupan	żupanek
żupan	żupanik
zupina	zupinka
zupa piwna	zupka piwna
zupa	zupka
żuraw	żurawik
zwierciadło	zwierciadełko
zwierzak	zwierzaczek
zwierzę	zwierzątko
żwir	żwirek
zwyczaj	zwyczaik
zydel	zydelek
zygzak	zygzaczek
żyłka	żyłeczka
żyła	żyłka
żytko	żyteczko
żyto	żytko
żywe srebro	żywe sreberko
żywopłot	żywopłocik